height 20
width 20
....................
....................
....................
....................
....@@@@@@@@@@@@....
....@@@@@@@@@@@@....
....@@@@@@@@@@@@....
....@@@@@@@@@@@@....
....@@@@@...........
.....@@@@....@@@....
.......@...@@@@@....
....@.....@@@@@@....
....@@....@@@@@@....
....@@@@@@@@@@@@....
....@@@@@@@@@@@@....
....@@@@@@@@@@@@....
....@@@@@@@@@@@@....
....................
....................
....................
